Step,d0,d1,w0,w1,Sirena,Central
0,1,1,1,1,0,0
1,0,1,1,1,0,0
2,0,0,1,1,0,0
3,0,0,1,1,0,0
4,1,0,1,1,0,0
5,1,0,1,1,0,0
6,1,1,1,1,0,0
7,1,1,1,1,0,1
